NO ./path_to_the_north_texture
SO ./path_to_the_south_texture
WE ./path_to_the_west_texture
EA ./path_to_the_east_texture
F 220,100,0


1111111111111111111111111
       10000000001111111111111
111111110100N0001000000100000011
10111101111011111101110000000001111
10100000010000000000000000000000001
10101110101111111111100001000000001
1010100000000000000010011111111111
101010111111101111101001101
1010000000000000000010011111111111
1011111111111111111010000000000001
1000000000000000000000000000000001
1111111111111100011111100011111111
             10001    10001
             10001    10001
             11111    11111