NO textures/bluestone.png
SO textures/bluestone.png
WE textures/bluestone.png
EA textures/bluestone.png
F 128,128,128
C  128,128,128

1111111111
1000001001
1000001001
1000001001
1011000001
1001000001
10110N0001
1000000001
1000000001
1111111111
